30 30
111111111111111111111111111111
10000000000000100000020k020001
100011111111101000000100010001
100010000000101000000100010001
100050000000101000000100010001
100010000000101000000100010001
100011111111101000000100010001
100000000000002000000100010001
111111111111122000000100010001
100000000000000000000100010001
100000000000000000000100010001
100000000000000000000000000001
100000000000010100000000000001
100040000000010100000000000001
100000000001110111000000333001
10000000000000m000000000313001
100000000001110111000000333001
100000000000010100000000000001
100000000000010100000000000001
191000000000000000000000000001
101000000000000000000000000001
101000000111111111111111111121
101000000000000000000000000001
101000000000000000000000000001
101000000111111111111111111121
101000000000000000000000000001
101000000000000000000000000001
101111111000000000000000000001
1@0000002000000000000000000001
111111111111111111111111111111
